NO ./textures/wall1.xpm
WE ./textures/wall3.xpm
SO ./textures/wall2.xpm
EA ./textures/wall4.xpm

C 225,30,25
F 220,10,0

         11111111111111111111111111
11111111100000000000000000111
10000000000001111100000000N01
1000000000000000000000000000111
1000000000000000000000000000001
1111111111111111111111111111111
                           