NO ./textures/wall1.xpm
SO ./textures/wall2.xpm
WE ./textures/wall3.xpm
EA ./textures/wall4.xpm
F 139,69,19
C 70,130,180

11111111111
10000000001
10111111101
10100000101
10101110101
10101010101
10101110101
10100000101
10111111101
10000000001
11111111111