NO ./textures/wall1.xpm
SO ./textures/wall2.xpm
WE ./textures/wall3.xpm
EA ./textures/wall4.xpm
F 50,50,50
C 10,10,10

11111111111111111111
1000000W001000000001
10111111101011111101
10100000001000000101
10101111111111110101
10100000000000010101
10111111101111110101
10000000101000000001
11111110101011111111
10000000101000000001
10111111101111111101
10100000000000000101
10101111111111110101
10101000000000010101
10101011111111010101
10000010000001000001
11111111111111111111