NO ./textures/wall1.xpm
SO ./textures/wall2.xpm
WE ./textures/wall3.xpm
EA ./textures/wall4.xpm
C 0,50
F 220,10,0



1111111111111111111111111111111
1000000000000000000000000001111
1000000000000111110000000000W1
1000000000000000000000000000111
1000000000000000000000000000001
1111111111111111111111111111111
