NO ./textures/wall1.xpm
SO ./textures/wall2.xpm
WE ./textures/wall3.xpm
EA ./textures/wall4.xpm
F 34,139,34
C 255,255,224

1111111111111111111111111
1000000000000000000000001
1000000000000000000000001
1000000000000000000000001
1000000000000000000000001
1000000001111100000000001
1000000001000100000000001
1000000001000100000000001
1000000001000100000000001
1000000001111100000000001
1000000000000000000000001
1000000000000E00000000001
1000000000000000000000001
1000000000000000000000001
1000000000000000000000001
1000000000000000000000001
1111111111111111111111111