NO ./textures/nonexistent1.xpm
SO ./textures/nonexistent2.xpm
WE ./textures/wall3.xpm
EA ./textures/wall4.xpm
C 0,50,200,300
F 220,10,0,99



1111111111111111111111111111111
1000000000000000000000000001111
1000000000000111110000000000W1
1000000000000000000000000000111
1000000000000000000000000000001
1111111111111111111111111111111
