NO ./textures/wall1.xpm
SO ./textures/wall2.xpm
WE ./textures/wall3.xpm
EA ./textures/wall4.xpm
C 0,50,200
F 220,10,0

11111111111111111
10000000000000001
10000W0000000001
10000000000000001
11111111111111111
